6 5
4 4 4 4 4
4 5 0 3 4
4 0 3 0 4
4 0 0 2 4
4 0 1 2 4
4 4 4 4 4
