6 10
4 4 4 4 4 4 4 4 4 4
4 2 0 3 0 2 0 0 5 4
4 0 3 0 2 0 0 3 3 4
4 0 0 2 0 2 2 2 2 4
4 0 1 2 3 0 0 3 3 4
4 4 4 4 4 4 4 4 4 4
