10 10
4 4 4 4 4 4 4 4 4 4
4 0 0 0 0 3 2 2 2 4
4 0 3 3 3 3 3 3 2 4
4 0 3 0 0 0 3 3 0 4
4 0 3 0 3 0 3 3 0 4
4 0 3 0 3 0 0 0 0 4
4 0 0 0 3 0 3 3 3 4
4 0 3 0 3 0 3 3 5 4
4 1 3 0 3 0 0 0 0 4
4 4 4 4 4 4 4 4 4 4
