10 10
4 4 4 4 4 4 4 4 4 4
4 0 5 0 0 0 0 0 2 4
4 0 0 0 0 0 2 0 0 4
4 0 2 0 0 2 0 0 0 4
4 0 0 2 0 0 0 0 0 4
4 2 0 0 3 0 0 2 0 4
4 0 3 0 0 0 0 0 0 4
4 2 3 0 1 0 3 3 0 4
4 2 3 0 0 0 0 2 2 4
4 4 4 4 4 4 4 4 4 4
